111111
10P011
111011
1E0011
101111
101C11
111111