111111111111111
10000000000C001
10010000P000001
111111000011111
1E00000C0000011
111111111111111