111111111111111
10000000000C001
100C0111P000001
111111000011011
1C00000C0111011
111100111E00011
111111111111111